=======
Credits
=======


Contributors
============

Thanks goes to all the kind PyInstaller contributors who have contributed
new code, bug reports, fixes, comments and ideas. A brief list follows,
please let us know if your name is omitted by accident:


* Shane Hansen - Linux arm support.

* Bryan A. Jones - docutils, jinja2, sphinx, pytz, idlelib import hooks.

* Martin Gamwell Dawids - AIX support.

* Hywel Richards - Solaris support.

* Brandyn White - packaged executable return code fix.

* Chien-An "Zero" Cho - PyUSB import hook.

* Daniel Hyams - wx.lib.pubsub import hook.

* Hartmut Goebel - Python logging system for message output. Option --log-level.

* Florian Hoech - full Python 2.6 support on Windows including automatic
  handling of DLLs, CRT, manifest, etc.

* Martin Zibricky - rewrite the build system for the bootloader using waf.
  LSB compliant precompiled bootloaders for Linux. Windows 64-bit support.

* Nathan Weston - Python architecture detection on OS X.

* Isaac Wagner - various OS X fixes.

* Matteo Bertini - OS X support.

* Daniele Zannotti - OS X support.

* David Mugnai - Linux support improvements.

* Arve Knudsen - absolute imports in Python 2.5+

* Pascal Veret - PyQt4 import hook with Qt4 plugins.

* Don Dwiggins - pyodbc import hook.

* Greg Copeland - sqlalchemy import hook.

* Marco Bonifazi - PyGTK hook improvements.

* Jamie Kirkpatrick - paste import hook.

* Lorenzo Mancini - PyXML import hook fixes under Windows. OS X support. App
  bundle creation on OS X. Tkinter on OS X. Precompiled bootloaders for OS X.

* Louai Al-Khanji - fixes with optparse module.

* Eugene Prigorodov - KInterasDB import hook.
